1 1 1 1 1 1 1 1 1 1 1 0 0 0 0 0
1 0 0 0 0 0 0 0 0 0 1 0 0 0 0 0
1 0 0 0 0 0 0 0 0 0 0 0 0 0 0 0
1 0 0 0 0 0 0 0 0 0 0 0 0 0 0 0
1 0 0 0 0 0 0 0 0 0 1 0 0 0 0 0
1 1 1 1 1 1 1 1 1 1 1 0 0 0 0 0
0 0 0 0 0 0 0 0 0 0 0 0 0 0 0 0
0 0 0 0 0 0 0 0 0 0 0 0 0 0 0 2
0 0 0 0 0 0 0 0 0 0 0 0 0 2 2 2
0 0 0 0 0 0 0 0 0 0 0 2 2 2 2 2
0 0 0 0 0 0 0 0 0 0 2 2 2 2 2 2
0 0 0 0 0 0 0 0 0 0 0 2 2 2 2 2

16 6 7 39 41 47 4 4 4 4 4 47 47 47 47 5 5 5 5 5 5 5 5 5 5 5 5 5 5 5 5 5 5 5 5 5 5 5 4 4 4 4 4 4 4 40 39 10 9 16
16 6 7 39 41 47 4 4 4 47 47 47 47 5 5 5 4 4 4 4 4 4 4 4 4 4 4 4 4 4 4 4 4 4 4 5 5 5 5 5 5 5 4 4 4 40 39 10 9 16
16 6 7 39 41 47 4 4 4 47 47 47 5 5 5 5 4 4 4 4 47 2 2 2 2 2 47 4 4 4 4 4 4 4 4 5 5 5 5 5 5 5 4 4 4 40 39 10 9 16
16 6 7 39 41 47 4 4 4 47 47 5 5 5 5 5 4 4 4 4 2 2 2 2 2 2 2 4 4 4 4 4 4 4 4 5 5 5 5 5 5 5 4 4 4 40 39 10 9 16
16 6 7 39 41 47 4 4 4 47 5 5 5 5 5 5 4 4 4 4 2 2 2 2 2 2 2 4 4 4 4 4 4 5 5 5 5 5 5 5 4 4 4 4 4 40 39 10 9 16
16 6 7 39 41 47 4 5 5 5 5 5 5 5 5 4 4 4 4 4 4 2 2 4 2 2 4 4 4 4 4 5 5 5 5 5 5 5 4 4 4 4 4 4 4 40 39 10 9 16
16 6 7 39 41 47 4 4 47 3 3 3 5 5 5 5 5 5 5 5 47 47 47 5 47 47 47 4 4 5 5 4 4 5 5 5 5 5 5 5 5 4 4 4 4 40 39 10 9 16
16 6 7 39 41 47 4 4 47 3 3 3 47 4 5 5 5 5 5 5 5 5 47 5 47 47 4 4 5 5 4 4 4 4 5 5 5 5 5 5 5 5 4 4 4 40 39 10 9 16
16 6 7 39 41 47 4 4 47 3 3 3 47 4 4 4 4 4 5 5 5 5 5 5 5 5 5 5 5 5 5 5 5 5 5 5 5 5 5 5 5 5 4 4 4 40 39 10 9 16
16 6 7 39 41 47 47 47 47 47 47 47 47 47 47 47 47 47 47 47 47 47 47 5 47 47 47 47 47 47 47 47 47 47 47 47 47 47 47 47 47 47 47 47 47 40 39 10 9 16
16 6 7 39 41 47 46 35 26 26 26 26 26 26 26 26 26 26 26 26 26 26 26 26 26 26 26 26 26 26 26 26 26 26 26 26 26 26 26 26 26 26 34 4 4 40 39 10 9 16
16 6 7 39 41 47 46 38 25 25 25 25 25 25 25 25 25 25 25 25 25 25 25 4 19 19 19 19 19 19 19 19 19 19 19 19 19 19 19 19 19 19 36 4 4 40 39 10 9 16
16 6 7 39 41 47 46 38 25 25 25 25 25 25 25 25 25 25 25 25 25 25 25 4 19 19 19 19 19 19 19 19 19 19 19 19 19 19 19 19 19 19 36 4 4 40 39 10 9 16
16 6 7 39 41 47 46 38 25 25 25 25 25 25 25 25 25 25 25 25 25 25 25 4 19 19 19 19 19 19 19 19 19 19 19 19 19 19 19 19 19 19 36 4 4 40 39 10 9 16
16 6 7 39 41 47 46 38 25 25 25 25 25 25 25 25 25 25 25 25 25 25 25 4 19 19 19 19 19 19 19 19 19 19 19 19 19 19 19 19 19 19 36 4 4 40 39 10 9 16
16 6 7 39 41 47 46 38 25 25 25 25 25 25 25 25 25 25 25 25 25 25 25 16 19 19 19 19 19 19 19 19 19 19 19 19 19 19 19 19 19 19 36 47 47 40 39 10 9 16
16 6 7 39 41 47 46 38 25 25 25 25 25 25 25 25 25 25 25 25 25 25 25 16 19 19 19 19 19 19 19 19 19 19 19 19 19 19 19 19 19 19 36 47 47 40 39 10 9 16
16 6 7 39 41 47 46 38 25 25 25 25 25 25 25 25 25 25 25 25 25 25 25 4 19 19 19 19 19 19 19 19 19 19 19 19 19 19 19 19 19 19 36 47 47 40 39 10 9 16
16 6 7 39 41 47 46 38 25 25 25 25 25 25 25 25 25 25 25 25 25 25 25 4 19 19 19 19 19 19 19 19 19 19 19 19 19 19 19 19 19 19 36 47 47 40 39 10 9 16
16 6 7 39 41 47 46 38 25 25 25 25 25 25 25 25 25 25 25 25 25 25 25 4 19 19 19 19 19 19 19 19 19 19 19 19 19 19 19 19 19 19 36 47 47 40 39 10 9 16
16 6 7 39 41 47 46 38 25 25 25 25 25 25 25 25 25 25 25 25 25 25 25 4 19 19 19 19 19 19 19 19 19 19 19 19 19 19 19 19 19 19 36 47 47 40 39 10 9 16
16 6 7 39 41 47 46 33 19 19 19 19 19 19 19 19 19 19 19 19 19 19 19 19 19 19 19 19 19 19 19 19 19 19 19 19 19 19 19 19 19 19 36 47 47 40 39 10 9 16
16 6 7 39 41 47 46 33 19 19 19 19 19 19 19 19 19 19 19 19 19 19 19 19 19 19 19 19 19 19 19 19 19 19 19 19 19 19 19 19 19 19 36 47 47 40 39 10 9 16
16 6 7 39 41 47 46 33 19 19 19 19 19 19 19 19 19 19 19 19 19 19 19 19 19 19 19 19 19 19 19 19 19 19 19 19 19 19 19 19 19 19 36 47 47 40 39 10 9 16
16 6 7 39 41 47 46 33 19 19 19 19 19 19 19 19 19 19 19 19 19 19 19 19 19 19 19 19 19 19 19 19 19 19 19 19 19 19 19 19 19 19 36 47 47 40 39 10 9 16
16 6 7 39 41 47 46 33 19 19 19 19 19 19 19 19 19 19 19 19 19 19 19 19 19 19 19 19 19 19 19 19 19 19 19 19 19 19 19 19 19 19 36 47 47 40 39 10 9 16
16 6 7 39 41 47 46 33 19 19 19 19 19 19 19 19 19 19 19 19 19 19 19 19 19 19 19 19 19 19 19 19 19 19 19 19 19 19 19 19 19 19 36 47 47 40 39 10 9 16
16 6 7 39 41 47 46 33 19 19 19 19 19 19 19 19 19 19 19 19 19 19 19 19 19 19 19 19 19 19 19 19 19 19 19 19 19 19 19 19 19 19 36 47 47 40 39 10 9 16
16 6 7 39 41 47 46 33 19 19 19 19 19 19 19 19 19 19 19 19 19 19 19 19 19 19 19 19 19 19 19 19 19 19 19 19 19 19 19 19 19 19 36 47 47 40 39 10 9 16
16 6 7 39 41 47 46 33 19 19 19 19 19 19 19 19 19 19 19 19 19 19 19 19 19 19 19 19 19 19 19 19 19 19 19 19 19 19 19 19 19 19 36 47 47 40 39 10 9 16
16 6 7 39 41 47 46 33 19 19 19 19 19 19 19 19 19 19 19 19 19 19 19 19 19 19 19 19 19 19 19 19 19 19 19 19 19 19 19 19 19 19 36 47 47 40 39 10 9 16
16 6 7 39 41 47 46 33 19 19 19 19 19 19 19 19 19 19 19 19 19 19 19 19 19 19 19 19 19 19 19 19 19 19 19 19 19 19 19 19 19 19 36 47 47 40 39 10 9 16
16 6 7 39 41 47 46 33 19 19 19 19 19 19 19 19 19 19 19 19 19 19 19 19 19 19 19 19 19 19 19 19 19 19 19 19 19 19 19 19 19 19 36 47 47 40 39 10 9 16
16 6 7 39 41 47 46 33 19 19 19 19 19 19 19 19 19 19 19 19 19 19 19 19 19 19 19 19 19 19 19 19 19 19 19 19 19 19 19 19 19 19 36 47 47 40 39 10 9 16
16 6 7 39 41 47 46 33 19 19 19 19 19 19 19 19 19 19 19 19 19 19 19 19 19 19 19 19 19 19 19 19 19 19 19 19 19 19 19 19 19 19 36 47 47 40 39 10 9 16
16 6 7 39 41 47 46 33 19 19 19 19 19 19 19 19 19 19 19 19 19 19 19 19 19 19 19 19 19 19 19 19 19 19 19 19 19 19 19 19 19 19 36 47 47 40 39 10 9 16
16 6 7 39 41 47 46 30 37 37 37 37 37 37 37 37 37 37 37 37 37 37 37 16 37 37 37 37 37 37 37 37 37 37 37 37 37 37 37 37 37 37 31 47 47 40 39 10 9 16
16 6 7 39 41 47 46 49 49 49 49 49 49 49 49 49 49 49 49 49 49 49 49 49 49 49 49 49 4 4 4 4 49 49 49 49 49 49 49 49 49 49 49 49 49 40 39 10 9 16
16 6 7 39 41 47 46 4 4 4 4 4 4 4 4 4 4 4 47 47 47 47 47 47 47 47 47 47 47 4 4 4 47 47 47 47 47 47 47 4 4 4 4 4 4 40 39 10 9 16
16 6 7 39 41 47 46 45 4 4 4 4 4 4 4 4 4 4 47 47 47 47 47 47 47 47 47 47 47 47 47 47 47 47 47 47 47 47 47 4 4 4 4 4 4 40 39 10 9 16
16 6 7 39 41 47 46 45 45 4 4 4 4 4 4 4 45 45 45 47 47 47 47 47 47 47 47 4 4 4 4 47 47 47 47 47 47 47 47 4 4 4 4 4 4 40 39 10 9 16
16 6 7 39 41 47 46 45 45 45 4 4 4 4 45 45 45 45 45 45 47 47 47 47 47 47 4 4 4 4 4 47 47 4 47 47 47 47 47 4 4 4 4 4 4 40 39 10 9 16
16 6 7 39 41 44 44 44 44 45 45 45 45 45 45 44 44 44 44 44 44 44 44 44 45 45 45 45 44 44 44 44 44 44 44 44 44 44 44 44 44 44 44 44 44 40 39 10 9 16
16 6 7 39 41 48 48 48 48 48 48 48 48 48 48 48 48 48 48 48 48 48 48 48 48 48 48 48 48 48 48 48 48 48 48 48 48 48 48 48 48 48 48 48 48 40 39 10 9 16
16 6 7 39 39 42 42 42 42 42 42 42 42 42 42 42 42 42 42 42 42 42 42 42 42 42 42 42 42 42 42 42 42 42 42 42 42 42 42 42 42 42 42 42 42 39 39 10 9 16
16 6 7 39 39 39 39 39 39 39 39 39 39 39 39 39 39 39 39 39 39 39 39 39 39 39 39 39 39 39 39 39 39 39 39 39 39 39 39 39 39 39 39 39 39 39 39 10 9 16
16 6 7 17 17 17 17 17 17 17 17 17 17 17 17 17 17 17 17 17 17 17 17 17 17 17 17 17 17 17 17 17 17 17 17 17 17 17 17 17 17 17 17 17 17 17 17 11 9 16
16 16 16 13 13 13 13 13 13 13 13 13 13 13 13 13 13 13 13 13 13 13 13 13 13 13 13 13 13 13 13 13 13 13 13 13 13 13 13 13 13 13 13 13 13 13 13 16 16 16
39 39 4 4 4 4 4 4 4 4 4 4 4 4 4 4 4 4 4 4 4 4 4 4 4 4 4 4 4 4 4 4 4 4 4 4 4 4 4 4 4 4 4 4 4 4 4 4 4 4 4
39 39 4 4 4 4 4 4 4 4 4 4 4 4 4 4 4 4 4 4 4 4 4 4 4 4 4 4 4 4 4 4 4 4 4 4 4 4 4 4 4 4 4 4 4 4 4 4 4 4 4