43 43 43 43 43 43 43 43 43 43 43 43 43 43 43 43 43 43 43 43 43 43 43 43 43 43 43 43 43 43
43 43 43 43 43 43 43 43 43 43 43 43 43 43 43 43 43 43 43 43 43 43 43 43 43 43 43 43 43 43
43 43 43 43 43 43 43 43 43 43 43 43 43 43 43 43 43 43 43 43 43 43 43 43 43 43 43 43 43 43
38 38 38 38 38 38 38 38 38 38 38 38 38 38 38 38 38 38 38 38 38 38 38 38 38 38 38 38 38 38
42 41 42 41 42 41 42 41 42 41 42 41 42 41 42 41 42 41 42 41 42 41 42 41 42 41 42 41 42 41
43 43 43 43 43 43 43 43 38 38 38 38 38 38 38 38 38 38 38 38 40 38 43 43 43 43 43 43 43 43
43 43 43 43 43 43 43 43 38 1 12 16 5 12 13 15 14 12 2 38 39 38 43 43 43 43 43 43 43 43 43
43 43 43 43 43 43 43 43 38 18 0 30 23 27 29 39 25 31 9 38 40 38 43 43 43 43 43 43 43 43 43
43 43 43 43 43 43 43 43 38 20 0 0 0 0 0 0 0 0 11 38 39 38 43 43 43 43 43 43 43 43 43
43 43 43 43 43 43 43 43 38 19 0 0 23 24 24 24 25 0 8 38 40 38 43 43 43 43 43 43 43 43 43
43 43 43 43 43 43 43 43 38 21 0 0 0 0 0 0 0 0 8 38 39 38 43 43 43 43 43 43 43 43 43
43 43 43 43 43 43 43 43 38 32 0 7 6 35 33 33 33 34 4 38 40 38 43 43 43 43 43 43 43 43 43
43 43 43 43 43 43 43 43 38 3 22 4 36 36 36 36 36 36 38 38 39 38 43 43 43 43 43 43 43 43 43
43 43 43 43 43 43 43 43 38 38 38 38 38 38 38 38 38 38 38 40 38 43 43 43 43 43 43 43 43 43
37 37 37 37 37 37 37 37 37 37 37 37 37 37 37 37 37 37 37 39 38 43 43 43 43 43 43 43 43 43
42 41 42 41 42 41 42 41 42 41 42 41 42 41 42 41 42 41 42 41 42 41 42 41 42 41 42 41 42 41
38 38 38 38 38 38 38 38 38 38 38 38 38 38 38 38 38 38 38 39 38 43 43 43 43 43 43 43 43 43
43 43 43 43 43 43 43 43 43 43 43 43 43 43 43 43 43 43 38 39 38 43 43 43 43 43 43 43 43 43
43 43 43 43 43 43 43 43 43 43 43 43 43 43 43 43 43 43 38 40 38 43 43 43 43 43 43 43 43 43
43 43 43 43 43 43 43 43 43 43 43 43 43 43 43 43 43 43 38 39 38 43 43 43 43 43 43 43 43 43