16 6 7 20 4 4 4 4 4 4 4 4 4 4 4 4 4 4 4 4 4 4 4 4 4 4 4 4 4 4 4 4 4 4 4 4 4 4 4 4 4 4 4 4 4 4 19 10 9 16
16 6 7 20 4 4 4 4 4 4 4 4 4 4 4 4 4 4 4 4 4 4 4 4 4 4 4 4 4 4 4 4 4 4 4 4 4 4 4 4 4 4 4 4 4 4 19 10 9 16
16 6 7 20 4 4 4 4 4 4 4 4 4 4 4 4 4 4 4 4 0 2 2 2 2 2 0 4 4 4 4 4 4 4 4 4 4 4 4 4 4 4 4 4 4 4 19 10 9 16
16 6 7 20 4 4 4 4 4 4 4 4 4 4 4 4 4 4 4 4 2 2 2 2 2 2 2 4 4 4 4 4 4 4 4 4 4 4 4 4 4 4 4 4 4 4 19 10 9 16
16 6 7 20 4 4 4 4 4 4 4 4 4 4 4 4 4 4 4 4 2 2 2 2 2 2 2 4 4 4 4 4 4 4 4 4 4 4 4 4 4 4 4 4 4 4 19 10 9 16
16 6 7 20 4 4 4 4 4 4 4 4 4 4 4 4 4 4 4 4 2 2 2 2 2 2 2 4 4 4 4 4 4 4 4 4 4 4 4 4 4 4 4 4 4 4 19 10 9 16
16 6 7 20 4 4 4 4 1 1 1 1 1 4 4 4 4 4 4 4 4 2 2 4 2 2 4 4 4 4 4 4 4 4 4 4 4 4 4 4 4 4 4 4 4 4 19 10 9 16
16 6 7 20 4 4 4 4 1 3 3 3 1 4 4 4 4 4 4 4 0 0 0 5 0 0 0 4 4 4 4 4 4 0 5 5 5 5 5 5 5 4 4 4 4 4 19 10 9 16
16 6 7 20 4 4 4 4 1 3 3 3 1 4 4 4 4 4 4 4 4 0 0 0 0 0 4 4 4 4 4 4 4 4 5 5 5 5 5 5 5 5 4 4 4 4 19 10 9 16
16 6 7 20 4 4 4 4 1 3 3 3 1 4 4 4 4 4 4 4 4 4 0 0 0 4 4 4 4 4 4 4 4 4 5 5 5 5 5 5 5 5 4 4 4 4 19 10 9 16
16 6 7 20 4 4 4 4 1 3 3 3 1 4 4 4 4 4 4 4 4 4 4 5 4 4 4 4 4 4 4 4 4 4 5 5 5 5 5 5 5 5 4 4 4 4 19 10 9 16
16 6 7 20 4 4 4 37 29 26 26 26 26 26 26 26 26 26 26 26 26 26 26 26 26 26 26 26 26 26 26 26 26 26 26 26 26 26 26 26 26 26 26 4 4 4 19 10 9 16
16 6 7 20 4 4 4 37 25 25 25 25 25 25 25 25 25 25 25 25 25 25 25 4 19 19 19 19 19 19 19 19 19 19 19 19 19 19 19 19 19 19 36 4 4 4 19 10 9 16
16 6 7 20 4 4 4 37 25 25 25 25 25 25 25 25 25 25 25 25 25 25 25 4 19 19 19 19 19 19 19 19 19 19 19 19 19 19 19 19 19 19 36 4 4 4 19 10 9 16
16 6 7 20 4 4 4 37 25 25 25 25 25 25 25 25 25 25 25 25 25 25 25 4 19 19 19 19 19 19 19 19 19 19 19 19 19 19 19 19 19 19 36 4 4 4 19 10 9 16
16 6 7 20 4 4 4 37 25 25 25 25 25 25 25 25 25 25 25 25 25 25 25 4 19 19 19 19 19 19 19 19 19 19 19 19 19 19 19 19 19 19 36 4 4 4 19 10 9 16
16 6 7 20 4 4 4 37 25 25 25 25 25 25 25 25 25 25 25 25 25 25 25 16 19 19 19 19 19 19 19 19 19 19 19 19 19 19 19 19 19 19 36 4 4 4 19 10 9 16
16 6 7 20 4 4 4 37 25 25 25 25 25 25 25 25 25 25 25 25 25 25 25 16 19 19 19 19 19 19 19 19 19 19 19 19 19 19 19 19 19 19 36 4 4 4 19 10 9 16
16 6 7 20 4 4 4 37 25 25 25 25 25 25 25 25 25 25 25 25 25 25 25 4 19 19 19 19 19 19 19 19 19 19 19 19 19 19 19 19 19 19 36 4 4 4 19 10 9 16
16 6 7 20 4 4 4 37 25 25 25 25 25 25 25 25 25 25 25 25 25 25 25 4 19 19 19 19 19 19 19 19 19 19 19 19 19 19 19 19 19 19 36 4 4 4 19 10 9 16
16 6 7 20 4 4 4 37 25 25 25 25 25 25 25 25 25 25 25 25 25 25 25 4 19 19 19 19 19 19 19 19 19 19 19 19 19 19 19 19 19 19 36 4 4 4 19 10 9 16
16 6 7 20 4 4 4 37 25 25 25 25 25 25 25 25 25 25 25 25 25 25 25 4 19 19 19 19 19 19 19 19 19 19 19 19 19 19 19 19 19 19 36 4 4 4 19 10 9 16
16 6 7 20 4 4 4 37 19 19 19 19 19 19 19 19 19 19 19 19 19 19 19 19 19 19 19 19 19 19 19 19 19 19 19 19 19 19 19 19 19 19 36 4 4 4 19 10 9 16
16 6 7 20 4 4 4 37 19 19 19 19 19 19 19 19 19 19 19 19 19 19 19 19 19 19 19 19 19 19 19 19 19 19 19 19 19 19 19 19 19 19 36 4 4 4 19 10 9 16
16 6 7 20 4 4 4 37 19 19 19 19 19 19 19 19 19 19 19 19 19 19 19 19 19 19 19 19 19 19 19 19 19 19 19 19 19 19 19 19 19 19 36 4 4 4 19 10 9 16
16 6 7 20 4 4 4 37 19 19 19 19 19 19 19 19 19 19 19 19 19 19 19 19 19 19 19 19 19 19 19 19 19 19 19 19 19 19 19 19 19 19 36 4 4 4 19 10 9 16
16 6 7 20 4 4 4 37 19 19 19 19 19 19 19 19 19 19 19 19 19 19 19 19 19 19 19 19 19 19 19 19 19 19 19 19 19 19 19 19 19 19 36 4 4 4 19 10 9 16
16 6 7 20 4 4 4 37 19 19 19 19 19 19 19 19 19 19 19 19 19 19 19 19 19 19 19 19 19 19 19 19 19 19 19 19 19 19 19 19 19 19 36 4 4 4 19 10 9 16
16 6 7 20 4 4 4 37 19 19 19 19 19 19 19 19 19 19 19 19 19 19 19 19 19 19 19 19 19 19 19 19 19 19 19 19 19 19 19 19 19 19 36 4 4 4 19 10 9 16
16 6 7 20 4 4 4 37 19 19 19 19 19 19 19 19 19 19 19 19 19 19 19 19 19 19 19 19 19 19 19 19 19 19 19 19 19 19 19 19 19 19 36 4 4 4 19 10 9 16
16 6 7 20 4 4 4 37 19 19 19 19 19 19 19 19 19 19 19 19 19 19 19 19 19 19 19 19 19 19 19 19 19 19 19 19 19 19 19 19 19 19 36 4 4 4 19 10 9 16
16 6 7 20 4 4 4 37 19 19 19 19 19 19 19 19 19 19 19 19 19 19 19 19 19 19 19 19 19 19 19 19 19 19 19 19 19 19 19 19 19 19 36 4 4 4 19 10 9 16
16 6 7 20 4 4 4 37 19 19 19 19 19 19 19 19 19 19 19 19 19 19 19 19 19 19 19 19 19 19 19 19 19 19 19 19 19 19 19 19 19 19 36 4 4 4 19 10 9 16
16 6 7 20 4 4 4 37 19 19 19 19 19 19 19 19 19 19 19 19 19 19 19 19 19 19 19 19 19 19 19 19 19 19 19 19 19 19 19 19 19 19 36 4 4 4 19 10 9 16
16 6 7 20 4 4 4 37 19 19 19 19 19 19 19 19 19 19 19 19 19 19 19 19 19 19 19 19 19 19 19 19 19 19 19 19 19 19 19 19 19 19 36 4 4 4 19 10 9 16
16 6 7 20 4 4 4 37 19 19 19 19 19 19 19 19 19 19 19 19 19 19 19 19 19 19 19 19 19 19 19 19 19 19 19 19 19 19 19 19 19 19 36 4 4 4 19 10 9 16
16 6 7 20 4 4 4 37 19 19 19 19 19 19 19 19 19 19 19 19 19 19 19 19 19 19 19 19 19 19 19 19 19 19 19 19 19 19 19 19 19 19 36 4 4 4 19 10 9 16
16 6 7 20 4 4 4 30 26 26 26 26 26 26 26 26 26 26 26 26 26 26 26 26 26 26 26 26 26 26 26 26 26 26 26 26 26 26 26 26 26 26 31 4 4 4 19 10 9 16
16 6 7 20 4 4 4 4 4 4 4 4 4 4 4 4 4 4 0 0 0 0 0 0 0 0 0 0 4 4 4 4 0 0 0 0 0 0 0 4 4 4 4 4 4 4 19 10 9 16
16 6 7 20 4 4 4 4 4 4 4 4 4 0 4 4 4 4 0 0 0 0 0 0 0 0 0 0 0 4 4 4 0 0 0 0 0 4 0 4 4 4 4 4 4 4 19 10 9 16
16 6 7 20 4 4 4 4 4 4 4 4 4 4 4 4 4 4 0 0 0 0 0 0 0 0 0 0 0 0 0 0 0 0 4 0 0 0 0 4 4 4 4 4 4 4 19 10 9 16
16 6 7 20 4 4 4 4 4 4 4 4 4 0 4 4 4 4 4 0 0 0 0 0 0 0 0 4 4 4 4 0 0 0 0 0 0 0 0 4 4 4 4 4 4 4 19 10 9 16
16 6 7 20 4 4 4 4 4 4 4 4 4 4 4 4 4 4 4 4 0 0 0 0 0 0 4 4 4 4 4 0 0 4 0 0 4 0 0 4 4 4 4 4 4 4 19 10 9 16
16 6 7 20 4 4 4 4 4 4 4 4 4 4 4 4 4 4 4 4 4 4 4 4 4 4 4 4 4 4 4 4 0 0 0 0 0 0 4 4 4 4 4 4 4 4 19 10 9 16
16 6 7 20 4 4 4 4 4 4 4 4 4 4 4 4 4 4 4 4 4 4 4 4 4 4 4 4 4 4 4 4 4 4 4 4 4 4 4 4 4 4 4 4 4 4 19 10 9 16
16 6 7 20 4 4 4 4 4 4 4 4 4 4 4 4 4 4 4 4 4 4 4 4 4 4 4 4 4 4 4 4 4 4 4 4 4 4 4 4 4 4 4 4 4 4 19 10 9 16
16 6 7 20 4 4 4 4 4 4 4 4 4 4 4 4 4 4 4 4 4 4 4 4 4 4 4 4 4 4 4 4 4 4 4 4 4 4 4 4 4 4 4 4 4 4 19 10 9 16
16 6 7 8 17 17 17 17 17 17 17 17 17 17 17 17 17 17 17 17 17 17 17 17 17 17 17 17 17 17 17 17 17 17 17 17 17 17 17 17 17 17 17 17 17 17 17 11 9 16
16 16 16 13 13 13 13 13 13 13 13 13 13 13 13 13 13 13 13 13 13 13 13 13 13 13 13 13 13 13 13 13 13 13 13 13 13 13 13 13 13 13 13 13 13 13 13 16 16 16
4 4 4 4 4 4 4 4 4 4 4 4 4 4 4 4 4 4 4 4 4 4 4 4 4 4 4 4 4 4 4 4 4 4 4 4 4 4 4 4 4 4 4 4 4 4 4 4 4 4