26 26 26 26 26 26 26 26 26 26 26 26 26 26 26 26 19 25 19 26 26 26 26 26 26
26 26 26 26 26 26 26 26 26 26 26 26 26 26 26 26 19 25 19 26 26 26 26 26 26
26 26 26 26 26 26 26 26 26 26 26 26 26 26 26 26 19 21 19 26 26 26 26 26 26
5 30 28 28 28 28 1 12 16 5 5 13 15 14 12 2 19 22 19 26 26 26 26 26 26
0 8 19 19 19 19 0 0 0 0 0 0 0 0 0 0 19 21 19 26 26 26 26 26 26
0 8 19 19 19 19 0 0 0 0 0 0 0 0 0 0 19 22 19 26 26 26 26 26 26
0 8 19 19 19 19 0 0 0 0 0 0 0 0 0 0 19 21 19 26 26 26 26 26 26
0 8 19 19 19 19 0 0 0 0 0 0 0 0 0 0 19 22 19 26 26 26 26 26 26
0 8 19 19 19 19 0 0 0 0 0 0 0 0 0 0 19 21 19 26 26 26 26 26 26
0 8 19 19 19 19 17 0 0 0 0 0 0 0 0 0 19 22 19 26 26 26 26 26 26
0 8 19 19 19 19 17 0 7 6 0 0 0 0 0 4 19 21 19 26 26 26 26 26 26
29 4 27 27 27 19 3 0 4 19 19 19 19 19 19 19 19 22 19 26 26 26 26 26 26
19 19 19 19 19 19 19 19 19 19 19 19 19 19 19 19 19 21 19 26 26 26 26 26 26
18 18 18 18 18 18 18 18 18 18 18 18 18 18 18 18 18 25 18 18 18 18 18 18 18
24 23 24 23 24 23 24 23 24 23 24 23 24 23 24 23 24 23 24 23 24 23 24 23 24